10 9 2
..........
......o...
.....o~o..
...oo~~oo.
.oo~~~oo..
..ooooooo.
.oToooooo.
.......o..
..........

..........
......B...
.....B....
...B.I..B.
.BP...B...
...B..B...
.B........
.......B..
..........

