8 9 2
........
.....o..
.ooooTo.
.oooooo.
.oooooo.
.oooooo.
.oooooo.
.oooooo.
........

........
.....B..
........
..F.....
........
........
..I..P..
........
........

