10 6 2
..........
..oooooo..
..ooooooo.
.oTo~~~~..
.....ooo..
..........

..........
..........
...I.PI.B.
.B........
.....BBB..
..........

