8 9 2
....oo..
.o.ooo..
.T.oooo.
.o.ooo..
.o.ooo..
.ooooo..
.o~~~~..
..oooo..
........

....BB..
.B......
....I.B.
...B....
........
.I...P..
........
....BB..
........

