8 8 2
........
....oo..
....oo..
....oo..
.~~~~~..
.oooo~o.
.Tooooo.
........

........
.....F..
........
....P...
........
.....I..
B.......
.....B..

