9 6 2
.........
.o~~~~~o.
.o~~~~~o.
.T~~~~~o.
.o~~~~~o.
.........

.........
...B.B...
.P..B....
B.....I..
..B...B..
...B.B...

