11 8 2
...........
.ooo.......
.oooooooo..
.ooooo~oo..
.ooooooToo.
.ooooo~oo..
.oooooooo..
...........

...........
...........
...........
......I....
.....FP..B.
......I....
...........
...........

