9 8 2

.........
.o~oooo..
.o~ooooo.
.o~~oooT.
.o~~~ooo.
..~~~ooo.
..o.oooo.
.........

.BB......
.B.......
.B...B.B.
.B......B
.B......B
.....I..B
..PBB....
.........

