8 6 2

........
.oooooo.
.oooooo.
.oooooo.
.Tooooo.
........

........
........
B.P..I..
........
B.......
.....B..


