8 7 2

NNNNNNNN
NGGGNNNN
NGGGGGGN
NGGGGGGN
NGGGGGGN
NTGGGGGN
NGNNNNNN

NNNNNNNN
NNNNNBNN
NNBNNNNN
BNNNNINN
NNNNNNNN
NNNNNPNN
NBNNNNNN

