8 7 2

........
....o~o.
...oo~o.
.o~~~oo.
.ooooooo
.Toooooo
........

.....B..
....B...
..B.I..B
BP...B..
..B..B..
B.......
......B.
