8 8 2

........
.oooooo.
.oo~~~o.
.oooooo.
.oooooo.
.oooooo.
.oooooo.
........

........
........
.PF...B.
........
..F.....
........
........
........
