10 8 2
..........
..........
.ooooooo..
.o~~~~~To.
...~oooo..
...ooooo..
..........
..........

..........
..........
..........
....I...B.
....P.F...
..........
..........
..........

