9 7 2
.........
.ooooooo.
.o~~~~~To
...~oooo.
...ooooo.
.........
.........

.........
.........
....I...B
....P.F..
.........
.........
.........

