9 8 2
.........
.oo...oo.
.o~~~~oo.
.oo~~ooo.
.oo~ooTo.
.........
.........
.........

.........
.........
..F......
.P.......
...I.....
.........
.........
.........

