11 10 2
...........
...oooo....
..oooo~o...
..oooT~~...
..oooo~~...
..oooo~~...
...ooo~~o..
...oooooo..
.....ooo...
...........

...........
.....BB....
..B........
....F......
...B.......
...........
.....B.I...
....P......
...........
...........

