10 9 2
.ooooo....
.ooooo....
.ooo~~....
.ooT~~....
.ooo~~....
.ooo~~....
.ooo~~....
.ooo~~o...
.oooooo...

....BB....
B.........
..........
..F.......
..........
..........
..........
...B.I....
......P...

