10 9 2
..........
..oooo....
.oooo~o...
.oooT~~...
.oooo~~...
.oooo~~...
..ooo~~o..
..oooooo..
....ooo...

..........
....BB....
.B........
...F......
..B.......
..P.......
....B.I...
..........
..........

