9 10 2
.........
..ooo....
.oTooo...
....oo...
....oooo.
...ooooo.
.ooooooo.
.ooooo~o.
.ooooooo.
.........

.........
..B......
.B.......
.........
....F.P..
...B.....
...B.....
......I..
....B....
.........

