9 10 2
.........
.........
.oTooo...
.~~.oo...
.~~.oooo.
.o~.oooo.
.o~ooooo.
.ooooooo.
.ooooooo.
.........

.........
..B.B....
.B...P...
.....F...
.........
.........
...B.....
......I..
....B....
.........

