9 10 2
.........
..ooo....
.oTooo...
.~~.oo...
.~~.oooo.
.o~ooooo.
.o~ooooo.
.ooooooo.
.ooooooo.
.........

.........
..B......
.B.......
.........
....P....
...BF....
...B.....
......I..
....B....
.........

