9 9 2
.........
......oo.
.ooooooo.
.oooooo~.
.oooooo~.
.oooooo~.
.oooooo~.
.ooooooo.
.....oo..

.........
.........
.........
...P.....
....I....
.........
.........
BF.......
BB.......

