10 10 2
..........
.ooo......
.ooo......
.oooooooo.
.ooooooTo.
.oooooooo.
.oooooooo.
.oooooooo.
.oooooooo.
..........

..........
..........
..........
..........
..F.......
..........
..........
..I....P..
..........
..........

