10 7 2
..........
..oo.o....
..oo~~oTo.
..ooooooo.
.ooooo~oo.
..ooooooo.
..........

..........
.....B....
...F....B.
....B...B.
.B....IPB.
....B...B.
..........

