9 7 2
.........
..oo.....
..oo~~oT.
..ooooooo
..oooo~oo
..ooooooo
.........

.........
.....B...
...F....B
....B...B
.B....IPB
....B...B
.........

