9 8 2
.........
.ooo.....
.ooo~~oT.
..ooo~~~.
..ooooooo
..oooo~oo
..ooooooo
.........

.........
..P..B...
...F....B
....B...B
....B...B
.B....I.B
....B...B
.........

