12 10 2
............
..ooo.......
.oo.o.......
.oooo.......
.~~o...oooo.
.o~~~~o~ooo.
.oooooooooo.
.oooooooooo.
.ooooooooTo.
............

............
............
...B........
.....B......
....BBB.....
............
.....B......
.PFI.B......
.....B......
.......BBB..

