9 9 2
.........
..oooooo.
.ooooooo.
.ooooooo.
.ooooo...
.oooTo...
.ooooo...
..o......
.........

.........
.........
.BPI..I..
.........
.........
.........
.....B...
..B......
.........

