8 8 2
........
.oooooo.
.oooooo.
.oooooo.
.oooo...
oooTo...
ooooo...
........

........
........
BPI..I..
........
........
........
....B...
.B......

