9 5 2
.........
.oooooo..
.ooooooo.
oTo~~~~..
....ooo..

.........
.........
..I.PI.B.
B........
....BBB..

