9 5 2
.........
.oooooo..
.oooooo..
.To~~~~..
.........

.........
.........
..I.PI.B.
B........
....BBB..

