10 9 2
..........
...oooooT.
...oo~....
....o~....
....oo....
...ooo....
.ooooo....
.ooooo....
..........

....B.....
.........B
..........
..........
.....F....
....I.....
..I...B...
....P.....
..........

