8 12 2
........
........
.ooooo..
.ooooo..
.~~~~~..
.~oooo..
.ooooo..
.ooooo..
.~~~~~o.
.oooo~o.
.Tooooo.
........

........
........
...F....
........
B.......
.I......
........
..B.....
......B.
.B...IP.
B.......
.....B..

