8 5 2
........
..oooT..
..oooo..
..oooo..
........

........
...P..B.
..IR....
........
........

