9 9 2
.........
.oooooo..
.oooooo..
.oooooo..
.oooooo..
.oooooo..
.ooooT...
.........
.........

.........
.......B.
...I.....
.......B.
....R.P..
..I......
.........
.....B...
.........

