9 9 2
.........
.oooooo..
.oooooo..
.oooooo..
.oooooo..
.oooooo..
.ooooTo..
.........
.........

.........
.......B.
..RI.....
.........
..I..P.B.
.........
.........
.....B...
.........

