10 9 2
..........
..........
.oooo.....
.o~~~ooo..
.oo~oooo..
.ooooooo..
.ooooooo..
.oooooooT.
..........

..........
..........
..........
..I.......
..........
.PF.......
.....BI...
.........B
...B......

