9 10 2
.........
...o.....
...Toooo.
...oo~oo.
.oooo~oo.
.o~o~ooo.
..oooooo.
..oooooo.
..oooooo.
.........

.........
...B.....
.........
.....I...
....BFP..
....I....
.........
.........
.........
.........

