10 8 2
..........
.oooo~ooo.
.oooo~ooo.
.oooo~Too.
.oooo~~oo.
.ooo~~ooo.
.oooo~ooo.
..........

..........
..........
..IPF.....
..........
..........
..........
..........
..........

