10 8 2
..........
..ooo~ooo.
..o~o~ooo.
..ooo~Too.
..ooo~~oo.
..oo~~ooo.
..ooo~ooo.
..........

..........
..........
...IF.....
...P......
..........
..........
..........
..........

