10 9 2
..........
.ooo~oo...
.ooo~oo...
.ooo~oo...
.ooo~ooo..
.ooo~~oo..
.oo~~ooo..
.ooo~oTo..
..........

..........
..........
..IF......
..........
..........
..........
..P.......
..........
......B...

