9 8 2
.........
.........
..oooo...
..ooTo...
.ooooo...
.o~oo....
.oooo....
.........

.........
.........
.........
.........
..F......
..IF.....
..P......
.........

