9 8 2
.........
.........
..oooo...
..ooTo...
.ooooo...
.oooo....
.oooo....
.........

.........
.........
.........
.........
..F......
..IF.....
...P.....
.........

