8 8 2
........
.oooooo.
.ooo~oo.
.ooo~oo.
.ooo~oo.
.ooo~oo.
.oooooo.
........

........
........
.PI.....
........
........
........
........
........

