8 8 2
........
.oooooo.
.oo~~oo.
.ooo~oo.
.ooo~oo.
.ooo~oo.
ooooooo.
........

........
........
..I.....
........
........
........
B...IP..
........

