8 8 2
........
.ooooo..
.oo~oo..
.~oooo..
.~T~oo..
.ooooo..
........
........

........
........
..F.F...
........
....I...
...P....
........
........

