8 8 2
........
.ooooo..
.ooToo..
.oo~oo..
.oo.oo..
.ooooo..
.ooooo..
........

........
........
..B.....
........
....I...
....P...
........
........

