10 7 2
...ooo....
...oooo...
....oooo..
..oTo~~o..
..oooooo..
..ooooo...
..........

..........
..........
..........
....PIF...
...I......
..........
..........

