10 8 2
..........
.oo.......
.ooooooo..
.ooooooo..
.oooooTo..
oooooooo..
oooooooo..
..........

..........
..........
..........
.....I....
....FP..B.
.....I....
..........
..........

