9 9 2
......oo.
oooooooo.
oooo~ooo.
.ooo~~oo.
.ooo~oTo.
.ooo~o...
.ooo~o...
.ooooo...
.........

.........
.........
......I..
...F.I...
...P.....
.........
.........
.........
.........

