9 12 2
.........
.........
.ooooooo.
.ooooooo.
.ooooooo.
.ooo~~oo.
.o~~oooo.
..~T~o...
..oooo...
..oooo...
..oooo...
.........

.........
.........
.........
.........
.BF..B...
.B..I....
.B...P...
.........
.........
.........
.........
.........

