8 10 2
........
.ooooo..
.ooooo..
.o~ooo..
.o~ooo..
.o~Too..
.ooooo..
........
........
........

........
........
..F.....
....F...
....I...
........
....P...
........
........
........

