12 8 2
............
............
....o.......
....T.......
..ooo~~o....
..oooooo....
............
............

............
............
....B.......
............
...F.I......
.......P....
............
............

