10 9 2
..........
..........
.oooooooo.
.oooooooo.
.o~~ooToo.
.ooo.o..o.
.ooooo~~o.
.oooooooo.
..........

..........
..........
..........
..........
.P.I......
..........
...F..I.F.
..........
..........

