10 11 2
..........
.ooooooo..
.ooooooo..
.o~~oooo..
.o~~oooo..
.o~~~oTo..
.ooooooo..
.ooooooo..
.ooooooo..
.ooooooo..
..........

..........
..........
..........
..B.......
..........
...I......
.B........
..........
...F..P...
..........
..........

