8 8 2
........
.oooooo.
.oooooo.
.oTo~~~.
.oooooo.
.oooooo.
.oooooo.
........

........
........
........
.B..I...
........
....FP..
........
........

