10 8 2
..........
..........
.oooooooo.
.oooooooo.
.ooToo~oo.
.oooooooo.
.oooooooo.
..........

..........
..........
..........
..........
..B..PI...
..........
..........
..........

