8 9 2
........
..ooo...
.ooooo..
.oooooo.
.oooo~o.
.oooooo.
.oTooo..
..o.o...
........

........
....B...
.B......
........
...B.IP.
........
........
..B.B...
........

