8 9 2
........
.ooo....
.ooo....
.oooooo.
.ooooTo.
.oooooo.
.o~oooo.
.oooooo.
........

........
........
........
........
..F.....
........
..I..P..
........
........

