12 11 2
............
..ooo.......
.oooo.......
.oooo.......
.~~oooooooo.
.o~~~~o~ooo.
.oooooooooo.
.oo~ooooooo.
.ooooooooTo.
.......ooo..
............

............
............
...B........
............
....BBB.....
............
.....B......
.PFI.B......
.....B......
.......BBB..
............

