9 10 2
.........
..ooooo..
.ooooooo.
.ooooooo.
.ooooooo.
.ooooooo.
.ooooooo.
...T.....
...o.....
.........

.........
..B......
.......B.
....B..B.
.B....I..
.BI...B..
......P..
.........
...B.....
.........

