9 13 2
.........
.........
..ooo....
..ooooo..
.o~~~~~..
..~oooo..
..ooooo..
..ooooo..
..~~~~~o.
..oooo~o.
.oTooooo.
......o..
.........

.........
.........
...F.....
.........
.B.......
..I......
.........
...B.....
.......B.
..B...IP.
.B.......
......B..
.........

