13 8 2
.............
.oooo..ooooo.
.oooo..oTooo.
.oooo..ooooo.
.ooo~~~~~~oo.
.oooo..ooooo.
.oooo..ooooo.
.............

........B....
.............
..P..........
.......B.....
..........I..
..IF.........
.............
.............

