11 11 2
...........
...........
.oooo......
.o~~~ooo...
.oo~oooo...
.ooooooo...
.ooooo~o...
.oooooooTo.
...o.......
...o.......
...........

...........
...........
...........
..I........
...........
.PF........
.....BI....
.........B.
...........
...B.......
...........

