11 10 2
...........
.oooo~oooo.
.oooo~oooo.
.o~~o~~ooo.
.oooo~oooo.
.oooo~oooo.
.oooo~oooo.
.oooT~oooo.
....o......
...........

...........
...........
...........
..IIF......
...P.......
...........
...........
...........
....B......
...........

