10 10 2
..........
.ooo~~ooo.
.ooo~~ooo.
.oo~~~ooo.
.ooo~~ooo.
.ooo~~ooo.
.ooo~~ooo.
.oooT~ooo.
....o.....
..........

..........
..........
..........
..I.......
...B..PF..
...I......
..........
..........
....B.....
..........

