9 10 2
.........
.........
.........
.oo~~oo..
.oo~~oo..
.ooT~oo..
.oo~~oo..
.oo~~oo..
.oooooo..
.........

.........
.........
.........
.........
.....P...
.........
..F..F...
....I....
.........
.........

