8 8 2
........
..o.oo..
..Tooo..
.oooooo.
.oooooo.
...o~oo.
...oooo.
........

........
..B.F...
........
........
........
....IF..
.....P..
........

