11 11 2
...........
.ooooooooo.
.ooooooooo.
.ooooooooo.
.ooo~~~ooo.
.ooo~T~ooo.
.ooo~~~ooo.
.ooooooooo.
.ooooooooo.
...........
...........

...........
...........
...........
...F.......
....I......
...........
......I....
.......P...
...........
...........
...........

